1111111111111111111111111111111111
1EC0000000000000C00000C00000000P01
1111111111111111111111111111111111